0,5,4,5,0,0,0
5,0,0,0,6,2,0
4,0,0,0,8,6,0
5,0,0,0,10,4,0
0,6,8,10,0,0,4
0,2,6,4,0,0,7
0,0,0,0,4,7,0